282 282 282 282 282 282 282 282 282 282 282 282 282 282 282 282 282 282 282 282 282 282 282 282 282 282 282 282 282 282 282 282 282 282 282 282 282 282 282 282 282 282 282 282 282 282 282 282 282 282 282 282 282 282 282 282 282 282 282 282 282 282 282 282 282 282 282 282 282 282 282 282 282 282 282 282 282 282 282 282 282 282 282 282 282 282 282 282 282 282 282 282 282 282 282 282 282 282 282 282 282 282 282 282 282 282 282 282 282 282 282 282 282 282 282 282 282 282 282 282 282 282 282 282 282 282 282 282 282 282 282 282 282 282 282 282 282 282 282 282 282 282 282 282 282 282 282 282 282 282 282 282 282 282 282 282 282 282 282 282 282 282 282 282 282 282 282 282 282 282 282 282 282 282 282 282 282 282 282 282 282 282 282 282 282 282 282 282 282 282 282 282 282 282 282 282 282 282 282 282 282 282 282 282 282 282 282 282 282 113 113 113 113 113 113 113 113 113 113 113 113 113 113 113 113 
282 282 282 282 282 282 282 282 282 282 282 282 282 282 282 282 282 282 282 282 282 282 282 282 282 282 282 282 282 282 282 282 282 282 282 282 282 282 282 282 282 282 282 282 282 282 282 282 282 282 282 282 282 282 282 282 282 282 282 282 282 282 282 282 282 282 282 282 282 282 282 282 282 282 282 282 282 282 282 282 282 282 282 282 282 282 282 282 282 282 282 282 282 282 282 282 282 282 282 282 282 282 282 282 282 282 282 282 282 282 282 282 282 282 282 282 282 282 282 282 282 282 282 282 282 282 282 282 282 282 282 282 282 282 282 282 282 282 282 282 282 282 282 282 282 282 282 282 282 282 282 282 282 282 282 282 282 282 282 282 282 282 282 282 282 282 282 282 282 282 282 282 282 282 282 282 282 282 282 282 282 282 282 282 282 282 282 282 282 282 282 282 282 282 282 282 282 282 282 282 282 282 282 282 282 282 282 282 282 113 113 113 113 113 113 113 113 113 113 113 113 113 113 113 113 
282 282 282 282 282 282 282 282 282 282 282 282 282 282 282 282 282 282 282 282 661 662 663 282 282 282 282 282 282 282 282 282 282 282 282 282 282 661 662 662 663 282 282 282 282 282 282 282 282 282 282 282 282 282 282 282 282 282 282 282 282 282 282 282 282 282 282 282 661 662 663 282 282 282 282 282 282 282 282 282 282 282 282 282 282 282 282 282 282 282 282 282 282 282 282 282 282 282 282 282 282 282 282 282 282 282 282 282 282 282 282 282 282 282 282 282 282 661 662 663 282 282 282 282 282 282 282 282 282 282 282 282 282 661 662 662 663 282 282 282 282 282 282 282 282 282 282 282 282 282 282 282 282 282 282 282 282 282 282 282 282 282 282 282 661 662 663 282 282 282 282 282 282 282 282 282 282 282 282 282 282 661 662 662 663 282 282 282 282 282 282 282 282 282 282 282 282 282 282 281 282 282 282 282 282 282 282 282 282 69 113 113 113 69 69 69 69 69 69 69 113 113 113 245 364 
282 282 282 282 282 282 282 282 282 661 662 663 282 282 282 282 282 282 282 282 694 695 696 282 282 282 282 282 661 662 662 662 663 282 282 282 282 694 695 695 696 282 282 282 282 282 282 282 282 282 282 282 282 282 282 282 282 661 662 663 282 282 282 282 282 282 282 282 694 695 696 282 282 282 282 282 661 662 662 662 663 282 282 282 282 282 282 282 282 282 282 282 282 282 282 282 282 282 282 282 282 282 282 282 282 661 662 663 282 282 282 282 282 282 282 282 282 694 695 696 282 282 282 282 661 662 662 662 663 282 282 282 282 694 695 695 696 282 282 282 282 282 282 282 282 282 282 282 282 282 282 282 282 661 662 663 282 282 282 282 282 282 282 282 694 695 696 282 282 282 282 282 661 662 662 662 663 282 282 282 282 694 695 695 696 282 282 282 282 282 282 282 282 282 282 282 282 282 456 457 282 661 662 663 282 282 282 282 282 69 113 113 113 113 113 113 113 113 113 113 113 113 113 113 364 
282 282 282 282 282 282 282 282 282 694 695 696 282 282 282 282 282 282 282 282 282 282 282 282 282 282 282 282 694 695 695 695 696 282 282 282 282 282 282 282 282 282 282 282 282 282 282 282 282 282 282 282 282 282 282 282 282 694 695 696 282 282 282 282 282 282 282 282 282 282 282 282 282 282 282 282 694 695 695 695 696 282 282 282 282 282 282 282 282 282 282 282 282 282 282 282 282 282 282 282 282 282 282 282 282 694 695 696 282 282 282 282 282 282 282 282 282 282 282 282 282 282 282 282 694 695 695 695 696 282 282 282 282 282 282 282 282 282 282 282 282 282 282 282 282 282 282 282 282 282 282 282 282 694 695 696 282 282 282 282 282 282 282 282 282 282 282 282 282 282 282 282 694 695 695 695 696 282 282 282 282 282 282 282 282 282 282 282 282 282 282 282 282 282 282 282 282 282 282 314 282 694 695 696 282 282 282 282 282 69 113 113 113 113 113 113 113 113 113 113 113 113 113 113 364 
282 282 282 282 282 282 282 282 282 282 282 282 282 282 282 282 282 282 282 282 282 282 282  282  282 282 282 282 282 282 282 282 282 282 282 282 282 282 282 282 282 282 282 282 282 282 282 282 282 282 282 282 282 282 282 282 282 282 282 282 282 282 282 282 282 282 282 282 282 282 282 282 282 282 282 282 282 282 282 282 282 282 2 282 2 282 2 282 2 282 282 282 282 2 282  282  282 282 282 282 282 282 282 282 282 282 282 282 282 282  282  282 282 282 282 282 282 282 282 282 282 282 282 2 282 282 282 282 282 282  282   282  282 282 282 282 282 282 282 282 282 282 282 282 282 282 282 282 282 282 282 282 282 282 282 282 282 282 282 282 282 282 282 282 282 282 282 282 282 282 282 282 282 282 282 282 282 282 282 282 282 282 282 282 282 282 282 282 282 0 34 282 282 282 282 282 282 282 282 314 282 282 282 282 282 282 282 282 282 69 113 113 113 113 113 113 113 113 113 113 113 113 113 113 364 
282 282 282 282 282 282 282 282 282 282 282 282 282 282 282 282 282 282 282 282 282 282 282 282 282 282 282 282 282 282 282 282 282 282 282 282 282 282 282 282 282 282 282 282 282 282 282 282 282 282 282 282 282 282 282 282 282 282 282 282 282 282 282 282 282 282 282 282 282 282 282 282 282 282 282 282 282 282 282 282 282 282 282 282 282 282 282 282 282 282 282 282 282 282 282 282 282 282 282 282 282 282 282 282 282 282 282 282 282 282 282 282 282 282 282 282 282 282 282 282 282 282 282 282 282 282 282 282 282 282 282 282 282 282 282 282 282 282 282 282 282 282 282 282 282 282 282 282 282 282 282 282 282 282 282 282 282 282 282 282 282 282 282 282 282 282 282 282 282 282 282 282 282 282 282 282 282 282 282 282 282 282 282 282 282 282 282 282 0 34 0 282 282 282 282 282 282 282 282 314 282 282 282 282 282 282 282 282 282 69 113 113 113 113 113 113 113 113 113 113 113 113 113 113 364 
282 282 282 282 282 282 282 282 282 282 282 282 282 282 282 282 282 282 282 282 282 282 282 282 282 282 282 282 282 282 282 282 282 282 282 282 282 282 282 282 282 282 282 282 282 282 282 282 282 282 282 282 282 282 282 282 282 282 282 282 282 282 282 282 282 282 282 282 282 282 282 282 282 282 282 282 282 282 282 282 282 282 282 282 282 282 282 282 282 282 282 282 282 282 282 282 282 282 282 282 282 282 282 282 282 282 282 282 282 282 282 282 282 282 282 282 282 282 282 282 282 282 282 282 282 282 282 282 282 282 282 282 282 282 282 282 282 282 282 282 282 282 282 282 282 282 282 282 282 282 282 282 282 282 282 282 282 282 282 282 282 282 282 282 282 282 282 282 282 282 282 282 282 282 282 282 282 282 282 282 282 282 282 282 282 282 282 0 34 0 34 282 282 282 282 282 282 282 282 314 282 282 282 282 282 282 282 282 282 69 113 113 113 113 113 113 113 113 113 113 113 113 113 113 364 
282 282 282 282 282 282 282 282 282 282 282 282 282 282 282 282 282 282 282 282 282 282 282 282 282 282 282 282 282 282 282 282 282 282 282 282 282 282 282 282 282 282 282 282 282 282 282 282 282 282 282 282 282 282 282 282 282 282 282 282 282 282 282 282 282 282 282 282 282 282 282 282 282 282 282 282 282 282 282 282 282 282 282 282 282 282 282 282 282 282 282 282 282 282 282 282 282 282 282 282 282 282 282 282 282 282 282 282 282 282 282 282 282 282 282 282 282 282 282 282 282 282 282 282 282 282 282 282 282 282 282 282 282 282 282 282 282 282 282 282 282 282 282 282 282 282 282 282 282 282 282 282 282 282 282 282 282 282 282 282 282 282 282 282 282 282 282 282 282 282 282 282 282 282 282 282 282 282 282 282 282 282 282 282 282 282 0 34 0 34 0 282 282 282 282 282 282 282 282 314 282 282 282 282 12 12 12 282 282 69 113 113 113 113 113 113 113 113 113 113 113 113 113 113 364 
282 282 282 282 282 282 282 282 282 282 282 282 282 282 282 282 282  282  282 282 282 282  282  282  282  282 282 282 282 282 282 282 282 282 282 282 282 282 282 282 282 282 282 282 282 282 282 265 266 282 282 282 282 282 282 282 282 282 265 266 282 282 282 282 282 282 282 282 282 282 282 282 282 282 282 282 282 282 282  282  282 282 282 282 282 282 282 282 282 282 282 282 282 282 282 282 282 282 282 282 282 282 2 282 282 282 282  282  282 282  282  282 282  282  282 282 282 282 282 282 282 282 282 282 282 282 282 282 282 282 282 2 282 282 282 282 282 282 0 282 282 0 282 282 282 282 282 282 282 282 282 282 0 34 282 282 0 34 282 282 282 282 282 282 282 282 282 282 282 282 2  282  282 282 282 282 282 282 282 282 282 282 282 282 282 0 34 0 34 0 34 282 282 282 282 282 282 282 282 314 282 282 282 282 13 3 15 282 282 69 113 113 113 113 113 113 113 113 113 113 113 113 113 113 364 
282 282 274 282 282 282 282 282 282 282 282 282 282 282 282 282 282 282 282 282 282 282 282 282 282 282 282 282 282 282 282 282 282 282 282 282 282 282 282 265 266 282 282 282 282 282 282 298 299 282 282 274 282 282 282 282 282 282 298 299 282 282 282 282 282 282 282 282 282 282 282 282 282 282 282 282 282 282 282 282 282 282 282 282 282 282 282 282 282 282 282 282 282 282 282 282 282 282 282 274 282 282 282 282 282 282 282 282 282 282 282 282 282 282 282 282 282 282 282 282 282 282 282 282 282 282 282 282 282 282 282 282 282 282 282 282 282 0 34 282 282 0 34 282 282 282 282 274 282 282 282 0 34 0 282 282 0 34 0 282 282 282 282 282 282 282 282 282 282 282 282 282 282 282 282 282 282 282 282 282 282 282 282 282 0 34 0 34 0 34 0 282 282 282 282 274 282 282 282 314 282 282 282 12 45 45 45 12 282 69 113 113 113 69 69 69 69 69 69 69 113 113 113 113 364 
282 273 306 275 282 282 282 282 282 282 282 282 282 282 282 282 282 282 274 282 282 282 282 282 282 282 282 282 282 265 266 282 282 282 282 282 282 282 282 298 299 282 282 282 282 282 282 298 299 282 273 306 275 282 282 282 282 282 298 299 282 282 282 282 282 282 274 282 282 282 282 282 282 282 282 282 282 282 282 282 282 282 282 282 282 282 282 282 282 282 282 282 282 282 282 282 282 282 273 372 275 282 282 282 282 282 282 282 282 282 282 282 282 282 274 282 282 282 282 282 282 282 282 282 282 282 282 282 282 282 282 282 282 282 282 282 0 34 0 282 282 0 34 0 282 282 273 306 275 282 0 34 0 34 282 282 0 34 0 34 282 282 274 282 0 0 282 282 282 282 282 282 282 282 282 282 282 282 282 282 0 0 282 0 34 0 34 0 34 0 34 282 282 282 273 306 275 282 282 314 282 282 282 3 3 46 3 3 282 69 113 113 113 69 69 69 69 69 69 69 113 113 0 0 269 
273 306 307 306 275 282 282 282 282 282 282 282 309 310 310 310 311 273 306 275 282 282 282 282 309 310 311 282 282 298 299 282 282 282 282 282 282 282 282 298 299 282 309 310 310 311 282 298 299 273 306 307 306 275 282 282 282 282 298 299 309 310 310 310 311 273 306 275 282 282 282 282 309 310 311 282 282 282 282 282 282 282 282 282 282 282 282 282 282 282 309 310 310 311 282 282 282 273 306 373 306 275 282 282 282 282 282 282 309 310 310 310 311 273 306 275 282 282 282 282 309 310 311 282 282 282 282 282 282 282 282 282 282 282 282 0 34 0 34 310 310 0 34 0 34 273 306 307 306 0 34 0 34 0 282 282 0 34 0 34 311 273 306 275 0 299 282 282 309 310 311 282 282 282 282 282 282 282 282 282 0 299 0 34 0 34 0 34 0 34 0 282 282 273 306 307 306 275 282 0 282 282 282 3 3 47 3 3 311 69 113 113 113 69 69 69 69 69 69 69 113 113 300 301 302 
1 1 1 1 1 1 1 1 1 1 1 1 1 1 1 1 1 1 1 1 1 1 1 1 1 1 1 1 1 1 1 1 1 1 1 1 1 1 1 1 1 1 1 1 1 1 1 1 1 1 1 1 1 1 1 1 1 1 1 1 1 1 1 1 1 1 1 1 1 1 282 282 1 1 1 1 1 1 1 1 1 1 1 1 1 1 1 282 282 282 1 1 1 1 1 1 1 1 1 1 1 1 1 1 1 1 1 1 1 1 1 1 1 1 1 1 1 1 1 1 1 1 1 1 1 1 1 1 1 1 1 1 1 1 1 1 1 1 1 1 1 1 1 1 1 1 1 1 1 1 1 1 1 1 282 282 1 1 1 1 1 1 1 1 1 1 1 1 1 1 1 1 1 1 1 1 1 1 1 1 1 1 1 1 1 1 1 1 1 1 1 1 1 1 1 1 1 1 1 1 1 1 1 1 1 1 1 1 1 67 67 67 67 67 67 67 67 67 67 67 67 67 67 67 67 
1 1 1 1 1 1 1 1 1 1 1 1 1 1 1 1 1 1 1 1 1 1 1 1 1 1 1 1 1 1 1 1 1 1 1 1 1 1 1 1 1 1 1 1 1 1 1 1 1 1 1 1 1 1 1 1 1 1 1 1 1 1 1 1 1 1 1 1 1 1 282 282 1 1 1 1 1 1 1 1 1 1 1 1 1 1 1 282 282 282 1 1 1 1 1 1 1 1 1 1 1 1 1 1 1 1 1 1 1 1 1 1 1 1 1 1 1 1 1 1 1 1 1 1 1 1 1 1 1 1 1 1 1 1 1 1 1 1 1 1 1 1 1 1 1 1 1 1 1 1 1 1 1 1 282 282 1 1 1 1 1 1 1 1 1 1 1 1 1 1 1 1 1 1 1 1 1 1 1 1 1 1 1 1 1 1 1 1 1 1 1 1 1 1 1 1 1 1 1 1 1 1 1 1 1 1 1 1 1 67 67 67 67 67 67 67 67 67 67 67 67 67 67 67 67
